#######===
#     ####
#XCO PP  #
#%###O##O#
#BB P  # #  
#BB    # #
#BB  # MM#
#BB #M MM# 
#E M#MMMM#
##########